abate: to lessen
aberration: a deviation from the norm
abhor: to hate
abstruse: difficult to understand
accolade: praise or distinction
acrimony: bitterness or hostility
acumen: keen insight
adroit: skillful
alacrity: eagerness
ambivalent: having mixed feelings
amiable: friendly
anachronistic: out of chronological order
anomaly: irregularity
antithesis: the direct opposite
apathy: lack of interest
apex: highest point
apprehensive: fearful or anxious
arduous: difficult
articulate: able to speak clearly
astute: clever, intelligent
avarice: greed
banal: boring, unoriginal
bellicose: warlike
benign: harmless
bombastic: pompous in speech
brevity: briefness
cacophony: harsh noise
candid: honest
capitulate: surrender
caustic: sarcastically biting
censure: to criticize harshly
chicanery: trickery
coerce: to force
cogent: convincing
cohesive: unified
collaborate: to work together
complacent: self-satisfied
concise: brief and to the point
condone: to overlook or forgive
conundrum: a difficult problem
copious: abundant
cursory: hasty
dauntless: fearless
debacle: a disaster
debunk: to expose as false
deleterious: harmful
demure: shy
deride: to mock
despot: a dictator
detrimental: damaging
didactic: instructive
diligent: hard-working
disdain: lack of respect
disparage: to belittle
disseminate: to spread
diverge: to separate
dogmatic: strongly opinionated
dubious: doubtful
ebullient: enthusiastic
eclectic: from various sources
egregious: outstandingly bad
elated: joyful
elucidate: to explain clearly
emulate: to imitate
enigma: mystery
ephemeral: short-lived
equanimity: calmness
esoteric: understood by few
eulogy: speech of praise
exacerbate: worsen
exemplary: outstanding
exonerate: to free from blame
extol: to praise
fallacy: a mistaken belief
fastidious: very careful
flagrant: blatant
fluctuate: to vary
formidable: intimidating
fortuitous: lucky
frivolous: unimportant
frugal: thrifty
galvanize: to inspire
garrulous: talkative
gregarious: sociable
guile: deceit
hackneyed: overused
haphazard: random
harangue: a long ranting speech
hedonist: pleasure-seeker
heresy: against orthodox opinion
hinder: to obstruct
hypothetical: assumed
iconoclast: one who attacks traditions
idiosyncrasy: personal peculiarity
imminent: about to happen
impetuous: impulsive
implacable: cannot be calmed
impugn: to call into question
inane: silly
indigent: poor
inevitable: unavoidable
infer: to deduce
innate: inborn
innocuous: harmless
insatiable: cannot be satisfied
insular: narrow-minded
intrepid: fearless
inundate: to flood
irascible: easily angered
irreverent: disrespectful
jubilant: extremely joyful
judicious: wise
laconic: using few words
lament: to express sorrow
languid: slow and sluggish
laud: to praise
lavish: extravagant
lethargic: tired, lazy
loquacious: talkative
lucid: clear
luminous: bright
magnanimous: generous
malevolent: having evil intent
malleable: capable of being shaped
maverick: an independent-minded person
meager: small in quantity
meander: to wander aimlessly
meticulous: very careful
mitigate: to make less severe
modicum: a small amount
mollify: to soothe
monotony: lack of variation
mundane: ordinary
myriad: a great number
nefarious: wicked
negligent: careless
neophyte: a beginner
nocturnal: active at night
noisome: offensive
nonchalant: unconcerned
novice: a beginner
noxious: harmful
nuance: a subtle difference
obdurate: stubborn
obfuscate: to make unclear
oblivious: unaware
obsequious: overly submissive
obsolete: no longer in use
obstinate: stubborn
obtrusive: pushing oneself forward
obtuse: not sharp-witted
ominous: threatening
omnipotent: all-powerful
onerous: burdensome
opaque: not letting light through
opulent: wealthy
ostentatious: showy
ostracize: to exclude
overt: open, not hidden
palliate: to make less severe
panacea: a cure-all
paradigm: a model or example
pariah: an outcast
parsimonious: stingy
partisan: biased
patronize: to talk down to
paucity: scarcity
pedantic: showing off learning
pedestrian: ordinary
penchant: a strong liking
pensive: thoughtful
perfidious: disloyal
perfunctory: done without care
permeate: to spread throughout
perseverance: persistence
peruse: to read carefully
pervasive: spreading everywhere
phlegmatic: calm, sluggish
piety: religious devotion
placate: to soothe
placid: calm
platitude: a dull remark
plausible: believable
plethora: an excess
poignant: emotionally moving
polemic: a strong verbal attack
ponderous: heavy, clumsy
pragmatic: practical
precarious: dangerous
precipitate: to cause to happen suddenly
preclude: to prevent
precocious: talented at a young age
predecessor: one who came before
predicament: a difficult situation
premonition: a feeling of future event
presumptuous: too forward
pretentious: showy
prevalent: widespread
pristine: pure
proclivity: a tendency
prodigal: wasteful
prodigious: enormous
profane: disrespectful
profound: deep
prolific: productive
propensity: a tendency
propitious: favorable
prosaic: dull
prosperous: wealthy
provincial: narrow-minded
prudent: careful
pugnacious: eager to fight
quaint: charmingly old-fashioned
quandary: a state of doubt
quell: to suppress
querulous: complaining
quiescent: inactive
quintessential: the most perfect example
quixotic: overly idealistic
rancorous: bitter
rapport: a close relationship
rash: impulsive
ratify: to approve
raucous: harsh and loud
ravenous: very hungry
rebuke: to criticize
recalcitrant: stubborn
recluse: one who lives alone
reconcile: to make peace
rectify: to correct
redoubtable: inspiring fear
redundant: repetitive
refute: to prove wrong
relegate: to assign to a lower position
relinquish: to give up
remiss: careless
remorse: regret
renounce: to give up
reprehensible: deserving blame
repudiate: to reject
rescind: to cancel
resilient: able to recover
resolute: determined
respite: a break
resplendent: shining
restorative: having the power to restore
reticent: silent
revere: to respect deeply
reverence: deep respect
rhetoric: the art of speaking
robust: strong
rouse: to wake up
rudimentary: basic
ruminate: to think deeply
rustic: rural
ruthless: showing no mercy
sagacious: wise
salient: significant
salutary: healthful
sanction: to approve
sanguine: optimistic
satiate: to satisfy fully
satire: making fun of something
scanty: insufficient
scrupulous: careful
scrutinize: to examine closely
seclude: to isolate
sedentary: sitting a lot
sedition: rebellion
sedulous: hard-working
serendipity: luck
serene: calm
servile: overly submissive
shrewd: clever
shroud: to cover
sloth: laziness
solicitous: concerned
somber: gloomy
sophomoric: immature
soporific: causing sleep
spartan: simple and severe
sporadic: irregular
spurious: false
stagnant: not moving
staunch: loyal
steadfast: firm
stigma: a mark of shame
stolid: showing no emotion
strident: loud and harsh
sublime: noble
submissive: yielding
substantiate: to prove
subtle: not obvious
subvert: to undermine
succinct: brief
succulent: juicy
supercilious: arrogant
superfluous: unnecessary
supplant: to replace
surfeit: an excess
surreptitious: secret
sycophant: a flatterer
tacit: understood without being said
taciturn: silent
tangible: touchable
tantamount: equivalent
tedious: boring
temerity: boldness
temperance: moderation
tenacious: persistent
tentative: uncertain
tenuous: weak
terse: brief
timorous: fearful
torpor: laziness
torrid: very hot
tractable: easily managed
transient: short-lived
trepidation: fear
trite: overused
truculent: eager to fight
truncate: to shorten
ubiquitous: found everywhere
unprecedented: never having happened before
upbraid: to scold
usurp: to seize power
utilitarian: useful
utopian: idealistic
vacillate: to waver
vacuous: empty
validate: to prove true
vapid: dull
variegated: varied
venerate: to respect
veracity: truthfulness
verbose: wordy
verdant: green
vestige: a trace
vex: to annoy
vicarious: experienced through another
vilify: to speak ill of
vindicate: to clear from blame
vindictive: seeking revenge
virtuoso: a master
virulent: harmful
viscous: thick and sticky
visionary: a dreamer
vital: essential
vituperate: to scold
vivacious: lively
vociferous: loud
volatile: unstable
voluminous: large
voracious: very hungry
wane: to decrease
wary: cautious
wax: to increase
whimsical: playful
wily: clever
wistful: longing
withdraw: to pull back
wither: to dry up
withhold: to hold back
witty: clever and funny
woe: sorrow
wrath: anger
zeal: enthusiasm
zealot: a fanatic
zenith: the highest point
aberrant: deviating from what is normal
abeyance: temporary suppression or suspension
abjure: to renounce formally
abnegation: self-denial
abrogate: to abolish or revoke formally
abscond: to leave secretly
abstemious: moderate in appetite
accretion: growth or increase by accumulation
acerbic: sharp and forthright
acquiesce: to accept something reluctantly
admonish: to warn or reprimand
adulation: excessive praise
adulterate: to make something poorer in quality
aesthetic: concerned with beauty
aggregate: a sum total
alleviate: to make suffering less severe
amalgamate: to combine or unite
ambiguous: open to more than one interpretation
ambivalence: mixed feelings
ameliorate: to make something better
anachronism: something out of place in time
analogous: comparable
anathema: something vehemently disliked
antipathy: deep-seated dislike
apocryphal: of doubtful authenticity
appease: to pacify
apprise: to inform
approbation: approval or praise
appropriate: to take for one's own use
artless: without guile
ascetic: severe self-discipline
assiduous: showing great care
assuage: to soothe
astringent: sharp or severe
asylum: protection granted by a state
attenuate: to reduce force or value
audacious: bold risks
austere: severe or strict
autonomous: self-governing
aver: to state to be the case
belie: to contradict
belligerent: hostile and aggressive
beneficent: generous
berate: to scold angrily
blight: a thing that damages
blithe: casual and cheerful indifference
bolster: to support
boorish: rough and bad-mannered
burgeon: to grow rapidly
burnish: to polish
buttress: a support
cajole: to persuade by coaxing
calumny: slander
capricious: impulsive and unpredictable
castigate: to reprimand severely
catalyst: something causing change
causality: relationship between cause and effect
coagulate: change to solid
coda: concluding passage
commensurate: corresponding in size
compendium: collection of detailed information
complaisant: willing to please
conciliatory: intended to pacify
confound: to cause surprise or confusion
connoisseur: expert judge
contention: heated disagreement
contentious: causing argument
conventional: based on what is generally done
convoluted: extremely complex
corroborate: to confirm
craven: cowardly
credulous: gullible
culpable: deserving blame
dearth: scarcity
debilitate: to make weak
decorous: in keeping with good taste
deference: humble submission
defunct: no longer existing
delineate: to describe precisely
demur: to raise doubts
denigrate: to criticize unfairly
derivative: imitative
desiccate: to remove moisture
desultory: lacking a plan
diatribe: bitter verbal attack
dichotomy: contrast between two things
diffident: modest or shy
diffuse: to spread over wide area
digression: temporary departure from subject
dilatory: slow to act
dilettante: amateur
dirge: lament for the dead
disabuse: to persuade someone belief is mistaken
discerning: having good judgment
discordant: disagreeing
discredit: to harm reputation
discrepancy: lack of compatibility
discrete: individually separate
disingenuous: not candid
disinterested: impartial
disjointed: lacking connection
dismiss: to treat as unworthy
disparate: essentially different
dispassionate: rational and impartial
dissemble: to conceal true motives
dissolution: closing down
dissonance: lack of harmony
distend: to swell
distill: to extract essential meaning
doctrinaire: imposing doctrine
dupe: to deceive
efficacy: effectiveness
effrontery: insolent boldness
elegy: poem of reflection
elicit: to evoke
embellish: to make more attractive
empirical: based on observation
endemic: regularly found in area
enervate: to drain of energy
engender: to cause or give rise to
ennui: boredom
equivocate: to use ambiguous language
erudite: showing great knowledge
euphemism: mild word for harsh one
exculpate: to clear from blame
exigency: urgent need
extraneous: irrelevant
facetious: flippant humor
facilitate: to make easier
fallacious: based on mistaken belief
fatuous: silly and pointless
fawning: exaggerated flattery
fecund: fertile
felicitous: well chosen
ferret: to search out
fervent: passionate intensity
fervid: intensely enthusiastic
flag: to become tired
fledgling: inexperienced
florid: red complexion or intricate
flout: to openly disregard
foment: to instigate
forbear: to refrain
forestall: to prevent by advance action
fractious: irritable
frugality: thriftiness
furtive: secretive
gainsay: to deny
germane: relevant
goad: to provoke
gouge: to cut or force out
grandiloquent: pompous language
guileless: innocent
gullible: easily persuaded
hapless: unfortunate
hegemony: leadership or dominance
homogeneous: of the same kind
hubris: excessive pride
hyperbole: exaggerated statements
idolatry: worship of idols
ignominious: deserving shame
immutable: unchanging
impair: to weaken
impassive: not showing emotion
impede: to delay
impermeable: not allowing fluid through
imperturbable: calm
impervious: unable to be affected
implicit: implied
implode: collapse inward
impunity: exemption from punishment
inadvertently: accidentally
inchoate: not fully formed
incongruity: out of keeping
inconsequential: not important
incontrovertible: undeniable
incorporate: to include
indefatigable: persisting tirelessly
indeterminate: not exactly known
indigence: extreme poverty
indolent: lazy
inert: lacking ability to move
ineffable: too great for words
ingenious: clever
ingenuous: innocent
inherent: existing as permanent attribute
insensible: unconscious
insinuate: to suggest indirectly
insipid: lacking flavor
insularity: ignorance of other cultures
intractable: hard to control
intransigent: unwilling to change views
inured: accustomed to unpleasantness
invective: abusive language
irresolute: uncertain
jocular: humorous
juxtapose: to place close together
keen: eager or sharp
knavery: dishonest dealings
largess: generosity
lassitude: lack of energy
laudable: deserving praise
levee: embankment
levity: humor in serious matter
malinger: to feign illness
mendacious: lying
metamorphosis: transformation
misanthrope: hater of humankind
morose: sullen
negate: to nullify
obviate: to remove a need
occlude: to obstruct
officious: domineering
opprobrium: harsh criticism
oscillate: to swing back and forth
paragon: perfect example
pathological: caused by disease
penury: extreme poverty
perennial: lasting long time
permeable: allowing liquids through
plasticity: easily shaped
plummet: to fall straight down
precursor: forerunner
prevaricate: to speak evasively
probity: honesty
problematic: constituting a problem
proliferate: to increase rapidly
propitiate: to win favor
propriety: conforming to standards
proscribe: to forbid
pungent: sharp taste or smell
qualified: limited or trained
quibble: slight objection
rarefy: to make less dense
recondite: little known
refractory: stubborn
replete: filled
rubric: set of instructions
salubrious: healthy
saturate: to soak thoroughly
savor: to enjoy
secrete: to produce and discharge
shard: piece of broken material
skeptical: having doubts
specious: superficially plausible
stint: allotted period of work
stipulate: to demand
striated: marked with ridges
subpoena: writ to attend court
subside: to become less intense
supersede: to take place of
supposition: uncertain belief
tangential: diverging
tirade: long angry speech
tortuous: full of twists
transgression: offense
transparent: allowing light through
trenchant: vigorous expression
truculence: aggressiveness
truism: obvious statement
tyro: beginner
underling: subordinate
unfeigned: genuine
unequivocal: unambiguous
unwitting: not aware
usury: illegal lending
vacillation: wavering
veneration: deep respect
veracious: truthful
verbosity: wordiness
veritable: used as intensifier
viscid: sticky
vituperative: bitter and abusive
volubility: talking fluently
waft: to pass gently
wheedle: to persuade by flattery
whet: to sharpen or stimulate
xenophobe: one who dislikes foreigners
zealous: showing great energy
anarchy: absence of governing body
anomalous: abnormal or irregular
cacophonous: discordant
castigation: punishment; severe criticism
compliant: yielding
contrite: penitent
converge: to approach; come together
daunt: to intimidate
decorum: propriety; good taste
default: failure to act
deterrent: something that discourages
diffidence: shyness
divest: to strip; deprive
document: to provide written evidence
dormant: sleeping; lethargic
enhance: to increase; improve
extrapolation: projection; conjecture
fervor: glowing ardor
futile: useless; hopeless
homogenous: of the same kind
intransigence: refusal of any compromise
itinerary: plan of a trip
latent: potential but undeveloped
log: record of a voyage
magnanimity: generosity
malingerer: one who feigns illness
porous: full of pores
preamble: introductory statement
prohibitive: tending to prevent
rarefied: made less dense
recant: to disclaim; retract
reproach: to express disapproval
reprobate: person hardened in sin
resolution: determination
resolve: determination
reverent: respectful
sage: person celebrated for wisdom
skeptic: doubter
spectrum: colored band
strut: supporting bar; pompous walk
viable: practical
warranted: justified